AF: Modulazione in Frequenza
AM: Modulazione in Ampiezza
ARQ: Automatic Repeat Request
ARP: Address Resolution Protocol
ATM: Asynchronous Transfer Mode
BPDU: Bridge Protocol Data Unit
CA: Collision Avoidance
CD: Collision Detection
CIDR: Classless Inter-Domain Routing
CRC: Cyclic Redundancy Check
CS: Carrier Sense
CSMA: Carrier Sense Multiple Access
CTS: Clear to Send
DCF: Distributed Coordination Function
DHCP: Dynamic Host Configuration Protocol
DNAT: Destination NAT
ECN: Explicit Congestion Notification
ESC: Byte di Escape
FCS: Frame Control Sequence
FDM: Frequency Division Multiplexing
ICMP: Internet Control Message Protocol
IFS: Inter-Frame Space
IP: Internet Protocol
ISM: Bande di Frequenza Libere senza licenza
LAR: Last Ack Received
LFS: Last Frame Sent
LLC: Logical Link Control
MAC: Medium Access Control
MTU: Maximum Transfer Unit
NAT: Network Address Translation
NRZ: Not Return to Zero
OFDM: Orthogonal Frequency Division Multiplexing
PAM: Modulazione ad Ampiezza di Impulsi
PCM: Pulse Code Modulation
PCF: Point Coordination Function
PPP: Point to Point Protocol
PSTN: Public Switched Telephone Network
QAM: Quadrature Amplitude Modulation
QoS: Quality of Service
RZ: Return to Zero
RTS: Request to Send
RTT: Round Trip Time
SLAAC: Stateless Address Auto Configuration
SNAT: Source NAT
SoF: Start of Frame
STP: Spanning Tree Protocol
TCNA: Topology Change Notification Ack
TCN: Topology Change Notification
TDM: Time Division Multiplexing
VLAN: Virtual Local Area Network